{
  "Dungeon": {
    "Dungeon": {
      "minRooms": 13,
      "maxRooms": 18,
      "ground": "DungeonGround",
      "outerWall": "DungeonWall",
      "innerWall": "DungeonBlock",
      "hole": "Hole",
      "door": "DungeonDoor",
      "pushableBlock": "DungeonBlock",
      "block": "DungeonBlock",
      "spikes": "DungeonSpikes",
      "chest": "DungeonChest",
      "minTreasureRooms": 1,
      "maxTreasureRooms": 2,
      "minMonsters": 2,
      "maxMonsters": 7,
      "monsters": [
        {
          "monster": "GreenSlimeSmall",
          "minChance": 1,
          "maxChance": 0
        },
        {
          "monster": "GreenSlime",
          "minChance": 0.25,
          "maxChance": 0.75
        },
        {
          "monster": "Orc",
          "minChance": 0,
          "maxChance": 1
        }
      ],
      "boss": "Dragon",
      "key": "DungeonKey",
      "bossKey": "DungeonBossKey",
      "locks": [
        {
          "lock": "KILL_MONSTER",
          "minChance": 0.75,
          "maxChance": 0.25
        },
        {
          "lock": "KEY",
          "minChance": 0.5,
          "maxChance": 0.75
        },
        {
          "lock": "PUSH_BLOCK",
          "minChance": 0.5,
          "maxChance": 0.5
        },
        {
          "lock": "INVISIBLE_DOOR",
          "minChance": 0,
          "maxChance": 0.75
        }
      ],
      "templates": [
        {
          "maxChance": 0.5,
          "template": [
            ["#", "#", "#", "#", "#", "#", "#", "#", "#", "#"],
            ["#", " ", " ", " ", " ", " ", " ", " ", " ", "#"],
            ["#", " ", " ", " ", " ", " ", " ", " ", " ", "#"],
            ["#", " ", " ", " ", " ", " ", " ", " ", " ", "#"],
            ["#", " ", " ", " ", " ", " ", " ", " ", " ", "#"],
            ["#", " ", " ", " ", " ", " ", " ", " ", " ", "#"],
            ["#", " ", " ", " ", " ", " ", " ", " ", " ", "#"],
            ["#", "#", "#", "#", "#", "#", "#", "#", "#", "#"]
          ]
        },
        {
          "template": [
            ["#", "#", "#", "#", "#", "#", "#", "#", "#", "#"],
            ["#", " ", " ", " ", " ", " ", ".", " ", " ", "#"],
            ["#", " ", " ", " ", " ", " ", ".", " ", " ", "#"],
            ["#", " ", " ", " ", " ", " ", ".", " ", " ", "#"],
            ["#", " ", " ", " ", " ", " ", ".", " ", " ", "#"],
            ["#", " ", " ", " ", " ", " ", ".", " ", " ", "#"],
            ["#", " ", " ", " ", " ", " ", " ", " ", " ", "#"],
            ["#", "#", "#", "#", "#", "#", "#", "#", "#", "#"]
          ]
        },
        {
          "maxChance": 0.5,
          "template": [
            ["#", "#", "#", "#", "#", "#", "#", "#", "#", "#"],
            ["#", "0", "0", "0", " ", " ", "0", "0", "0", "#"],
            ["#", "0", "0", "0", " ", " ", "0", "0", "0", "#"],
            ["#", " ", " ", " ", " ", " ", " ", " ", " ", "#"],
            ["#", " ", " ", " ", " ", " ", " ", " ", " ", "#"],
            ["#", "0", "0", "0", " ", " ", "0", "0", "0", "#"],
            ["#", "0", "0", "0", " ", " ", "0", "0", "0", "#"],
            ["#", "#", "#", "#", "#", "#", "#", "#", "#", "#"]
          ]
        },
        {
          "template": [
            ["#", "#", "#", "#", "#", "#", "#", "#", "#", "#"],
            ["#", " ", " ", " ", " ", " ", " ", " ", " ", "#"],
            ["#", " ", "p", " ", " ", " ", " ", "+", " ", "#"],
            ["#", " ", " ", " ", " ", " ", " ", " ", " ", "#"],
            ["#", " ", " ", " ", " ", " ", " ", " ", " ", "#"],
            ["#", " ", "+", " ", " ", " ", " ", "+", " ", "#"],
            ["#", " ", " ", " ", " ", " ", " ", " ", " ", "#"],
            ["#", "#", "#", "#", "#", "#", "#", "#", "#", "#"]
          ]
        },
        {
          "template": [
            ["#", "#", "#", "#", "#", "#", "#", "#", "#", "#"],
            ["#", " ", " ", " ", " ", " ", " ", " ", " ", "#"],
            ["#", " ", " ", " ", " ", " ", " ", " ", " ", "#"],
            ["#", " ", "+", "+", "0", "0", "+", "+", " ", "#"],
            ["#", " ", "+", "+", "0", "0", "+", "+", " ", "#"],
            ["#", " ", " ", " ", " ", " ", " ", " ", " ", "#"],
            ["#", " ", " ", " ", " ", " ", " ", " ", " ", "#"],
            ["#", "#", "#", "#", "#", "#", "#", "#", "#", "#"]
          ]
        },
        {
          "template": [
            ["#", "#", "#", "#", "#", "#", "#", "#", "#", "#"],
            ["#", " ", " ", " ", " ", " ", " ", " ", " ", "#"],
            ["#", " ", " ", " ", " ", " ", " ", " ", " ", "#"],
            ["#", " ", " ", " ", "+", "+", " ", " ", " ", "#"],
            ["#", " ", " ", " ", "+", "+", " ", " ", " ", "#"],
            ["#", " ", " ", " ", " ", " ", " ", " ", " ", "#"],
            ["#", " ", " ", " ", " ", " ", " ", " ", " ", "#"],
            ["#", "#", "#", "#", "#", "#", "#", "#", "#", "#"]
          ]
        },
        {
          "template": [
            ["#", "#", "#", "#", "#", "#", "#", "#", "#", "#"],
            ["#", " ", " ", " ", " ", " ", " ", " ", " ", "#"],
            ["#", " ", "+", "+", "+", "+", "+", "+", " ", "#"],
            ["#", " ", " ", " ", " ", " ", " ", " ", " ", "#"],
            ["#", " ", " ", " ", " ", " ", " ", " ", " ", "#"],
            ["#", " ", "+", "+", "+", "+", "+", "+", " ", "#"],
            ["#", " ", " ", " ", " ", " ", " ", " ", " ", "#"],
            ["#", "#", "#", "#", "#", "#", "#", "#", "#", "#"]
          ]
        },
        {
          "template": [
            ["#", "#", "#", "#", "#", "#", "#", "#", "#", "#"],
            ["#", " ", " ", " ", " ", " ", " ", " ", " ", "#"],
            ["#", " ", "+", "+", "+", "+", "+", "+", " ", "#"],
            ["#", " ", " ", " ", " ", " ", " ", "+", " ", "#"],
            ["#", " ", " ", " ", " ", " ", " ", "+", " ", "#"],
            ["#", " ", "+", "+", "+", "+", "+", "+", " ", "#"],
            ["#", " ", " ", " ", " ", " ", " ", " ", " ", "#"],
            ["#", "#", "#", "#", "#", "#", "#", "#", "#", "#"]
          ]
        },
        {
          "template": [
            ["#", "#", "#", "#", "#", "#", "#", "#", "#", "#"],
            ["#", " ", " ", " ", " ", " ", " ", " ", " ", "#"],
            ["#", " ", "+", " ", " ", " ", " ", "+", " ", "#"],
            ["#", " ", "+", " ", " ", " ", " ", "+", " ", "#"],
            ["#", " ", "+", " ", " ", " ", " ", "+", " ", "#"],
            ["#", " ", "+", " ", " ", " ", " ", "+", " ", "#"],
            ["#", " ", " ", " ", " ", " ", " ", " ", " ", "#"],
            ["#", "#", "#", "#", "#", "#", "#", "#", "#", "#"]
          ]
        },
        {
          "template": [
            ["#", "#", "#", "#", "#", "#", "#", "#", "#", "#"],
            ["#", " ", " ", " ", " ", " ", " ", " ", " ", "#"],
            ["#", " ", "+", "+", " ", " ", "+", "+", " ", "#"],
            ["#", " ", "+", " ", " ", " ", " ", "+", " ", "#"],
            ["#", " ", "+", " ", " ", " ", " ", "+", " ", "#"],
            ["#", " ", "+", "+", " ", " ", "+", "+", " ", "#"],
            ["#", " ", " ", " ", " ", " ", " ", " ", " ", "#"],
            ["#", "#", "#", "#", "#", "#", "#", "#", "#", "#"]
          ]
        },
        {
          "isBossRoom": true,
          "template": [
            ["#", "#", "#", "#", "#", "#", "#", "#", "#", "#"],
            ["#", "+", "+", "+", " ", " ", "+", "+", "+", "#"],
            ["#", "+", "+", " ", "b", " ", " ", "+", "+", "#"],
            ["#", " ", " ", " ", " ", " ", " ", " ", " ", "#"],
            ["#", " ", " ", " ", " ", " ", " ", " ", " ", "#"],
            ["#", " ", "+", " ", " ", " ", " ", "+", " ", "#"],
            ["#", " ", " ", " ", " ", " ", " ", " ", " ", "#"],
            ["#", "#", "#", "#", "#", "#", "#", "#", "#", "#"]
          ]
        },
        {
          "isTreasureRoom": true,
          "template": [
            ["#", "#", "#", "#", "#", "#", "#", "#", "#", "#"],
            ["#", " ", " ", " ", " ", " ", " ", " ", " ", "#"],
            ["#", " ", "+", "+", "+", "+", "+", "+", " ", "#"],
            ["#", " ", "+", " ", " ", " ", " ", "+", " ", "#"],
            ["#", " ", "+", " ", "c", " ", " ", "+", " ", "#"],
            ["#", " ", "+", "+", " ", " ", "+", "+", " ", "#"],
            ["#", " ", " ", " ", " ", " ", " ", " ", " ", "#"],
            ["#", "#", "#", "#", "#", "#", "#", "#", "#", "#"]
          ]
        }
      ]
    }
  }
}