{
  "Dungeon": {
    "Dungeon": {
      "roomCount": [6, 7, 8, 8, 9, 9, 10, 11],
      "ground": "DungeonGround",
      "outerWall": "DungeonWall",
      "innerWall": "DungeonBlock",
      "door": "DungeonDoor",
      "monsters": ["GreenSlime"],
      "key": "DungeonKey",
      "locks": ["KILL_MONSTER", "KEY", "PUSH_BLOCK"],
      "lockChance": 0.5,
      "templates": [
        {
          "template": [
            ["#", "#", "#", "#", "#", "#", "#", "#", "#", "#", "#", "#", "#", "#", "#", "#"],
            ["#", " ", " ", " ", " ", " ", " ", " ", " ", " ", " ", " ", " ", " ", " ", "#"],
            ["#", " ", " ", " ", " ", " ", " ", " ", " ", " ", " ", " ", " ", " ", " ", "#"],
            ["#", " ", " ", " ", " ", " ", " ", " ", " ", " ", " ", " ", " ", " ", " ", "#"],
            ["#", " ", " ", " ", " ", " ", " ", " ", " ", " ", " ", " ", " ", " ", " ", "#"],
            ["#", " ", " ", " ", " ", " ", " ", " ", " ", " ", " ", " ", " ", " ", " ", "#"],
            ["#", " ", " ", " ", " ", " ", " ", " ", " ", " ", " ", " ", " ", " ", " ", "#"],
            ["#", "#", "#", "#", "#", "#", "#", "#", "#", "#", "#", "#", "#", "#", "#", "#"]
          ]
        },
        {
          "template": [
            ["#", "#", "#", "#", "#", "#", "#", "#", "#", "#", "#", "#", "#", "#", "#", "#"],
            ["#", " ", " ", " ", " ", " ", " ", " ", " ", " ", " ", " ", " ", " ", " ", "#"],
            ["#", " ", "+", " ", " ", " ", " ", " ", " ", " ", " ", " ", " ", "+", " ", "#"],
            ["#", " ", " ", " ", " ", " ", " ", " ", " ", " ", " ", " ", " ", " ", " ", "#"],
            ["#", " ", " ", " ", " ", " ", " ", " ", " ", " ", " ", " ", " ", " ", " ", "#"],
            ["#", " ", "+", " ", " ", " ", " ", " ", " ", " ", " ", " ", " ", "+", " ", "#"],
            ["#", " ", " ", " ", " ", " ", " ", " ", " ", " ", " ", " ", " ", " ", " ", "#"],
            ["#", "#", "#", "#", "#", "#", "#", "#", "#", "#", "#", "#", "#", "#", "#", "#"]
          ]
        },
        {
          "template": [
            ["#", "#", "#", "#", "#", "#", "#", "#", "#", "#", "#", "#", "#", "#", "#", "#"],
            ["#", " ", " ", " ", " ", " ", " ", " ", " ", " ", " ", " ", " ", " ", " ", "#"],
            ["#", " ", " ", " ", " ", " ", " ", " ", " ", " ", " ", " ", " ", " ", " ", "#"],
            ["#", " ", " ", " ", "+", "+", " ", " ", " ", " ", "+", "+", " ", " ", " ", "#"],
            ["#", " ", " ", " ", "+", "+", " ", " ", " ", " ", "+", "+", " ", " ", " ", "#"],
            ["#", " ", " ", " ", " ", " ", " ", " ", " ", " ", " ", " ", " ", " ", " ", "#"],
            ["#", " ", " ", " ", " ", " ", " ", " ", " ", " ", " ", " ", " ", " ", " ", "#"],
            ["#", "#", "#", "#", "#", "#", "#", "#", "#", "#", "#", "#", "#", "#", "#", "#"]
          ]
        },
        {
          "template": [
            ["#", "#", "#", "#", "#", "#", "#", "#", "#", "#", "#", "#", "#", "#", "#", "#"],
            ["#", " ", " ", " ", " ", " ", " ", " ", " ", " ", " ", " ", " ", " ", " ", "#"],
            ["#", " ", " ", " ", " ", " ", " ", " ", " ", " ", " ", " ", " ", " ", " ", "#"],
            ["#", " ", " ", " ", " ", " ", " ", "+", "+", " ", " ", " ", " ", " ", " ", "#"],
            ["#", " ", " ", " ", " ", " ", " ", "+", "+", " ", " ", " ", " ", " ", " ", "#"],
            ["#", " ", " ", " ", " ", " ", " ", " ", " ", " ", " ", " ", " ", " ", " ", "#"],
            ["#", " ", " ", " ", " ", " ", " ", " ", " ", " ", " ", " ", " ", " ", " ", "#"],
            ["#", "#", "#", "#", "#", "#", "#", "#", "#", "#", "#", "#", "#", "#", "#", "#"]
          ]
        },
        {
          "template": [
            ["#", "#", "#", "#", "#", "#", "#", "#", "#", "#", "#", "#", "#", "#", "#", "#"],
            ["#", " ", " ", " ", " ", " ", " ", " ", " ", " ", " ", " ", " ", " ", " ", "#"],
            ["#", " ", "+", "+", "+", "+", "+", "+", "+", "+", "+", "+", "+", "+", " ", "#"],
            ["#", " ", " ", " ", " ", " ", " ", " ", " ", " ", " ", " ", " ", " ", " ", "#"],
            ["#", " ", " ", " ", " ", " ", " ", " ", " ", " ", " ", " ", " ", " ", " ", "#"],
            ["#", " ", "+", "+", "+", "+", "+", "+", "+", "+", "+", "+", "+", "+", " ", "#"],
            ["#", " ", " ", " ", " ", " ", " ", " ", " ", " ", " ", " ", " ", " ", " ", "#"],
            ["#", "#", "#", "#", "#", "#", "#", "#", "#", "#", "#", "#", "#", "#", "#", "#"]
          ]
        },
        {
          "flip": "HORIZONTAL",
          "template": [
            ["#", "#", "#", "#", "#", "#", "#", "#", "#", "#", "#", "#", "#", "#", "#", "#"],
            ["#", " ", " ", " ", " ", " ", " ", " ", " ", " ", " ", " ", " ", " ", " ", "#"],
            ["#", " ", "+", "+", "+", "+", "+", "+", "+", "+", "+", "+", "+", "+", " ", "#"],
            ["#", " ", " ", " ", " ", " ", " ", " ", " ", " ", " ", " ", " ", "+", " ", "#"],
            ["#", " ", " ", " ", " ", " ", " ", " ", " ", " ", " ", " ", " ", "+", " ", "#"],
            ["#", " ", "+", "+", "+", "+", "+", "+", "+", "+", "+", "+", "+", "+", " ", "#"],
            ["#", " ", " ", " ", " ", " ", " ", " ", " ", " ", " ", " ", " ", " ", " ", "#"],
            ["#", "#", "#", "#", "#", "#", "#", "#", "#", "#", "#", "#", "#", "#", "#", "#"]
          ]
        },
        {
          "template": [
            ["#", "#", "#", "#", "#", "#", "#", "#", "#", "#", "#", "#", "#", "#", "#", "#"],
            ["#", " ", " ", " ", " ", " ", " ", " ", " ", " ", " ", " ", " ", " ", " ", "#"],
            ["#", " ", "+", " ", "+", " ", "+", " ", " ", "+", " ", "+", " ", "+", " ", "#"],
            ["#", " ", "+", " ", "+", " ", "+", " ", " ", "+", " ", "+", " ", "+", " ", "#"],
            ["#", " ", "+", " ", "+", " ", "+", " ", " ", "+", " ", "+", " ", "+", " ", "#"],
            ["#", " ", "+", " ", "+", " ", "+", " ", " ", "+", " ", "+", " ", "+", " ", "#"],
            ["#", " ", " ", " ", " ", " ", " ", " ", " ", " ", " ", " ", " ", " ", " ", "#"],
            ["#", "#", "#", "#", "#", "#", "#", "#", "#", "#", "#", "#", "#", "#", "#", "#"]
          ]
        },
        {
          "template": [
            ["#", "#", "#", "#", "#", "#", "#", "#", "#", "#", "#", "#", "#", "#", "#", "#"],
            ["#", " ", " ", " ", " ", " ", " ", " ", " ", " ", " ", " ", " ", " ", " ", "#"],
            ["#", " ", "+", " ", " ", "+", " ", " ", " ", " ", "+", " ", " ", "+", " ", "#"],
            ["#", " ", "+", " ", " ", "+", " ", " ", " ", " ", "+", " ", " ", "+", " ", "#"],
            ["#", " ", "+", " ", " ", "+", " ", " ", " ", " ", "+", " ", " ", "+", " ", "#"],
            ["#", " ", "+", " ", " ", "+", " ", " ", " ", " ", "+", " ", " ", "+", " ", "#"],
            ["#", " ", " ", " ", " ", " ", " ", " ", " ", " ", " ", " ", " ", " ", " ", "#"],
            ["#", "#", "#", "#", "#", "#", "#", "#", "#", "#", "#", "#", "#", "#", "#", "#"]
          ]
        },
        {
          "flip": "VERTICAL",
          "template": [
            ["#", "#", "#", "#", "#", "#", "#", "#", "#", "#", "#", "#", "#", "#", "#", "#"],
            ["#", " ", " ", "#", "#", "#", "#", " ", " ", "#", "#", "#", "#", " ", " ", "#"],
            ["#", " ", " ", "#", "#", "#", "#", " ", " ", "#", "#", "#", "#", " ", " ", "#"],
            ["#", " ", " ", "#", "#", "#", "#", " ", " ", "#", "#", "#", "#", " ", " ", "#"],
            ["#", " ", " ", "#", "#", "#", "#", " ", " ", "#", "#", "#", "#", " ", " ", "#"],
            ["#", " ", " ", " ", " ", " ", " ", " ", " ", " ", " ", " ", " ", " ", " ", "#"],
            ["#", " ", " ", " ", " ", " ", " ", " ", " ", " ", " ", " ", " ", " ", " ", "#"],
            ["#", "#", "#", "#", "#", "#", "#", "#", "#", "#", "#", "#", "#", "#", "#", "#"]
          ]
        },
        {
          "flip": "BOTH",
          "template": [
            ["#", "#", "#", "#", "#", "#", "#", "#", "#", "#", "#", "#", "#", "#", "#", "#"],
            ["#", " ", " ", "#", "#", "#", "#", " ", " ", " ", " ", " ", " ", " ", " ", "#"],
            ["#", " ", " ", "#", "#", "#", "#", " ", " ", " ", " ", " ", " ", " ", " ", "#"],
            ["#", " ", " ", "#", "#", "#", "#", " ", " ", " ", " ", " ", " ", " ", " ", "#"],
            ["#", " ", " ", "#", "#", "#", "#", " ", " ", " ", " ", " ", " ", " ", " ", "#"],
            ["#", " ", " ", " ", " ", " ", " ", " ", " ", " ", " ", " ", " ", " ", " ", "#"],
            ["#", " ", " ", " ", " ", " ", " ", " ", " ", " ", " ", " ", " ", " ", " ", "#"],
            ["#", "#", "#", "#", "#", "#", "#", "#", "#", "#", "#", "#", "#", "#", "#", "#"]
          ]
        },
        {
          "flip": "BOTH",
          "template": [
            ["#", "#", "#", "#", "#", "#", "#", "#", "#", "#", "#", "#", "#", "#", "#", "#"],
            ["#", " ", " ", "#", "#", "#", "#", " ", " ", " ", " ", " ", " ", " ", " ", "#"],
            ["#", " ", " ", "#", "#", "#", "#", " ", " ", " ", " ", " ", " ", " ", " ", "#"],
            ["#", " ", " ", "#", "#", "#", "#", " ", " ", "#", "#", "#", "#", " ", " ", "#"],
            ["#", " ", " ", "#", "#", "#", "#", " ", " ", "#", "#", "#", "#", " ", " ", "#"],
            ["#", " ", " ", " ", " ", " ", " ", " ", " ", "#", "#", "#", "#", " ", " ", "#"],
            ["#", " ", " ", " ", " ", " ", " ", " ", " ", "#", "#", "#", "#", " ", " ", "#"],
            ["#", "#", "#", "#", "#", "#", "#", "#", "#", "#", "#", "#", "#", "#", "#", "#"]
          ]
        },
        {
          "flip": "BOTH",
          "template": [
            ["#", "#", "#", "#", "#", "#", "#", "#", "#", "#", "#", "#", "#", "#", "#", "#"],
            ["#", "#", "#", "#", "#", "#", "#", " ", " ", " ", " ", " ", " ", " ", " ", "#"],
            ["#", "#", "#", "#", "#", "#", "#", " ", " ", " ", " ", " ", " ", " ", " ", "#"],
            ["#", " ", " ", " ", " ", " ", " ", " ", " ", " ", " ", " ", " ", " ", " ", "#"],
            ["#", " ", " ", " ", " ", " ", " ", " ", " ", " ", " ", " ", " ", " ", " ", "#"],
            ["#", " ", " ", " ", " ", " ", " ", " ", " ", " ", " ", " ", " ", " ", " ", "#"],
            ["#", " ", " ", " ", " ", " ", " ", " ", " ", " ", " ", " ", " ", " ", " ", "#"],
            ["#", "#", "#", "#", "#", "#", "#", "#", "#", "#", "#", "#", "#", "#", "#", "#"]
          ]
        },
        {
          "flip": "BOTH",
          "template": [
            ["#", "#", "#", "#", "#", "#", "#", "#", "#", "#", "#", "#", "#", "#", "#", "#"],
            ["#", "#", "#", "#", "#", "#", "#", " ", " ", "#", "#", "#", "#", "#", "#", "#"],
            ["#", "#", "#", "#", "#", "#", "#", " ", " ", "#", "#", "#", "#", "#", "#", "#"],
            ["#", " ", " ", " ", " ", " ", " ", " ", " ", " ", " ", " ", " ", " ", " ", "#"],
            ["#", " ", " ", " ", " ", " ", " ", " ", " ", " ", " ", " ", " ", " ", " ", "#"],
            ["#", " ", " ", " ", " ", " ", " ", " ", " ", " ", " ", " ", " ", " ", " ", "#"],
            ["#", " ", " ", " ", " ", " ", " ", " ", " ", " ", " ", " ", " ", " ", " ", "#"],
            ["#", "#", "#", "#", "#", "#", "#", "#", "#", "#", "#", "#", "#", "#", "#", "#"]
          ]
        },
        {
          "flip": "BOTH",
          "template": [
            ["#", "#", "#", "#", "#", "#", "#", "#", "#", "#", "#", "#", "#", "#", "#", "#"],
            ["#", "#", "#", "#", "#", "#", "#", " ", " ", " ", " ", " ", " ", " ", " ", "#"],
            ["#", "#", "#", "#", "#", "#", "#", " ", " ", " ", " ", " ", " ", " ", " ", "#"],
            ["#", " ", " ", " ", " ", " ", " ", " ", " ", " ", " ", " ", " ", " ", " ", "#"],
            ["#", " ", " ", " ", " ", " ", " ", " ", " ", " ", " ", " ", " ", " ", " ", "#"],
            ["#", " ", " ", " ", " ", " ", " ", " ", " ", "#", "#", "#", "#", "#", "#", "#"],
            ["#", " ", " ", " ", " ", " ", " ", " ", " ", "#", "#", "#", "#", "#", "#", "#"],
            ["#", "#", "#", "#", "#", "#", "#", "#", "#", "#", "#", "#", "#", "#", "#", "#"]
          ]
        },
        {
          "flip": "BOTH",
          "template": [
            ["#", "#", "#", "#", "#", "#", "#", "#", "#", "#", "#", "#", "#", "#", "#", "#"],
            ["#", "#", "#", "#", "#", "#", "#", " ", " ", " ", " ", " ", " ", " ", " ", "#"],
            ["#", "#", "#", "#", "#", "#", "#", " ", " ", " ", " ", " ", " ", " ", " ", "#"],
            ["#", " ", " ", "#", "#", "#", "#", " ", " ", "#", "#", "#", "#", " ", " ", "#"],
            ["#", " ", " ", "#", "#", "#", "#", " ", " ", "#", "#", "#", "#", " ", " ", "#"],
            ["#", " ", " ", " ", " ", " ", " ", " ", " ", "#", "#", "#", "#", "#", "#", "#"],
            ["#", " ", " ", " ", " ", " ", " ", " ", " ", "#", "#", "#", "#", "#", "#", "#"],
            ["#", "#", "#", "#", "#", "#", "#", "#", "#", "#", "#", "#", "#", "#", "#", "#"]
          ]
        },
        {
          "flip": "BOTH",
          "template": [
            ["#", "#", "#", "#", "#", "#", "#", "#", "#", "#", "#", "#", "#", "#", "#", "#"],
            ["#", "#", "#", "#", "#", "#", "#", " ", " ", "#", "#", "#", "#", "#", "#", "#"],
            ["#", "#", "#", "#", "#", "#", "#", " ", " ", "#", "#", "#", "#", "#", "#", "#"],
            ["#", " ", " ", "#", "#", "#", "#", " ", " ", "#", "#", "#", "#", " ", " ", "#"],
            ["#", " ", " ", "#", "#", "#", "#", " ", " ", "#", "#", "#", "#", " ", " ", "#"],
            ["#", " ", " ", " ", " ", " ", " ", " ", " ", " ", " ", " ", " ", " ", " ", "#"],
            ["#", " ", " ", " ", " ", " ", " ", " ", " ", " ", " ", " ", " ", " ", " ", "#"],
            ["#", "#", "#", "#", "#", "#", "#", "#", "#", "#", "#", "#", "#", "#", "#", "#"]
          ]
        },
        {
          "template": [
            ["#", "#", "#", "#", "#", "#", "#", "#", "#", "#", "#", "#", "#", "#", "#", "#"],
            ["#", " ", " ", " ", " ", " ", " ", " ", " ", " ", " ", " ", " ", " ", " ", "#"],
            ["#", " ", "#", "#", "#", "#", "#", "#", "#", "#", "#", "#", "#", "#", " ", "#"],
            ["#", " ", "#", "#", "#", "#", "#", "#", "#", "#", "#", "#", "#", "#", " ", "#"],
            ["#", " ", "#", "#", "#", "#", "#", "#", "#", "#", "#", "#", "#", "#", " ", "#"],
            ["#", " ", "#", "#", "#", "#", "#", "#", "#", "#", "#", "#", "#", "#", " ", "#"],
            ["#", " ", " ", " ", " ", " ", " ", " ", " ", " ", " ", " ", " ", " ", " ", "#"],
            ["#", "#", "#", "#", "#", "#", "#", "#", "#", "#", "#", "#", "#", "#", "#", "#"]
          ]
        },
        {
          "template": [
            ["#", "#", "#", "#", "#", "#", "#", "#", "#", "#", "#", "#", "#", "#", "#", "#"],
            ["#", " ", " ", " ", " ", " ", " ", " ", " ", " ", " ", " ", " ", " ", " ", "#"],
            ["#", " ", "#", "#", "#", "#", "#", " ", " ", "#", "#", "#", "#", "#", " ", "#"],
            ["#", " ", "#", "#", "#", "#", "#", " ", " ", "#", "#", "#", "#", "#", " ", "#"],
            ["#", " ", "#", "#", "#", "#", "#", " ", " ", "#", "#", "#", "#", "#", " ", "#"],
            ["#", " ", "#", "#", "#", "#", "#", " ", " ", "#", "#", "#", "#", "#", " ", "#"],
            ["#", " ", " ", " ", " ", " ", " ", " ", " ", " ", " ", " ", " ", " ", " ", "#"],
            ["#", "#", "#", "#", "#", "#", "#", "#", "#", "#", "#", "#", "#", "#", "#", "#"]
          ]
        }
      ]
    }
  }
}